eleje inkabb külföldi:

- Papaoutai - Stromae
- Waiting for Love - Avicii
- Chop Suey! - System Of a Down
- Lemon Tree - Fools Garden
- This is America - Childish Gambino
- Jumpsuit - Twenty One Pilots
- Old Town Road - Lil Nas X
- R U Mine - Arctic Monkeys
- Immigrant Song - Led Zeppelin
- Can't Help Falling in Love - Elvis Presley
- Crazy - Gnarls Barkley
- Sweet Caroline - Neil Diamond
- Bad guy - billie eilish
- Can't Hold us - Macklemore & Ryan Lewis
- Peer gynt: In the Hall of the mountain King - Edvard Grieg

Magyarok:
- Csavargó - Bohemian Betyars
- Tihany - Csaknekedkislány
- Nekem Senkim Sincsen - vad fruttik
- Bogozd ki - 30y
- Partizán - Punnany Massif
- Olyan Ő - Bagossy Brothers Company (ez mondjuk könnyű ANNAK aki ismeri)
- Ha megnyitod a szíved - Ivan & the parazol
- Legnagyobb hős - HoneyBeast
- Mamma maria - Korda György
- SzintisLaci - Ricsárdgír
- Csillag vagy fecske - Kispál és a Borz
- Mocsár - aurevoir
- A 67-es út - Republic
- Sehol se talállak - Quimby
- Belehalok - Majka

